Mapsize: 26 x 19
|---------------------------------------------------------------------------------------------------------------------------------|
|   X.    .    .    .    .    .    .    .    .    .    .    .    .    .    .    .    .    .    .    .    .    .    .    .    .   X|
|    .    .    .    .    .    .    .    .    .    .    .    .    .    .    .    .    .    .    .    .    .    .    .    .    .    |
| . .|-------------------|-------------------|-----DDDD-----|---------|--------------|-------------------|-------------------|. . |
|    |    .    .    .    |    .    .    .    |    .    .    |    .    |    .    .    |    .    .    .    |    .    .    .    |    |
|    |  01.  01.  01.  01|  10.  10.  10.  10|  05.  05.  05|    .    |  13.  13.  13|  14.  14.  14.  14|  16.  16.  16.  16|    |
| . .|. . . . . . . . . .|. . . . . . . . . .|. . . . . . . |---------| . . . . . . .|. . . . . . . . . .|. . . . . . . . . .|. . |
|    |    .    .    .    |    .    .Mor .    |    .    .    |    .    |    .    .    |    .    .    .    |    .    .    .    |    |
|    |  01.  01.  01.  01|  10.  10.  10.  10|  05.  05.  05|    .    |  13.  13.  13|  14.  14.  14.  14|  16.  16.  16.  16|    |
| . .|. . . . . . . . . .|. . . . . . . . . .|. . . . . . . | . . . . | . . . . . . .|. . . . . . . . . .|. . . . . . . . . .|. . |
|    |    .    .    .    |    .    .    .    D    .    .    |    .    |    .    .    |    .    .    .    |    .    .    .    |    |
|    |  01.  01.  01.  01|  10.  10.  10.  10D  05.  05.  05|    .    |  13.  13.  13|  14.  14.  14.  14|  16.  16.  16.  16|    |
| . .|-------------------|-------------------|. . . . . . . | . . . . | . . . . . . .|. . . . . . . . . .|. . . . . . . . . .|. . |
|    |    .    .    .    |    .    .    .    |    .    .    |    .    |    .    .    |    .    .    .    |    .    .    .    |    |
|    |  02.  02.  02.  02|  04.  04.  04.  04|  05.  05.  05|    .    |  13.  13.  13|  14.  14.  14.  14|  16.  16.  16.  16|    |
| . .|. . . . . . . . . .|. . . . . . . . . .|. . . . . . . | . . . . | . . . . . . .|-------------------|-------------------|. . |
|    |    .    .    .    |    .    .    .    S    .    .    |    .    |    .    .    |    .    .    .    D    .    .    .    |    |
|    |  02.  02.  02.  02|  04.  04.  04.  04S  05.  05.  05|    .    |  13.  13.  13|  15.  15.  15.  15D  17.  17.  17.  17|    |
| . .|. . . . . . . . . .|. . . . . . . . . .|---------|----| . . . . |--------------|. . . . . . . . . .|. . . . . . . . . .|. . |
|    |    .    .    .    |    .    .    .    |    .    |    |    .    .    .    .    |    .    .    .    |    .Mor .    .    D    |
|    |  02.  02.  02.  02|  04.  04.  04.  04|    .    |    |    .    .    .    .    |  15.  15.  15.  15|  17.  17.  17.  17D    |
| . .|. . . . . . . . . .|. . . . . . . . . .|. . |----|----|-------------------| . .|. . . . . . . . . .|. . . . . . . . . .|. . |
|    D    .    .    .    D    .    .    .    |    |    .    .    .    .    .    |    |    .    .    .    |    .    .    .    |    |
|    D  02.  02.  02.  02D  04.  04.  04.  04|    |  12.  12.  12.  12.  12.  12|    |  15.  15.  15.  15|  17.  17.  17.  17|    |
|----|. . . . . . . . . .|. . . . . . . . . .|. . | . . . . . . . . . . . . . . | . .|. . . . . . . . . .|. . . . . . . . . .|. . |
|    |    .    .    .    |    .    .    .    |    |    .    .   A.   A.    .    |    |    .    .    .    |    .    .    .    |    |
|    |  02.  02.  02.  02|  04.  04.  04.  04|    |  12.  12.st12.* 12.  12.  12|    |  15.  15.  15.  15|  17.  17.  17.  17|    |
|----|----------SSSS-----|-------------------|. . | . . . . . . . . . . . . . . | . .|----|-----DDDD-----|-------------------|. . |
|    .    .    .    .    .    .    .    .    .Mor D    .    .   A.   A.    .    DMor |    |    .    .    .    .    .    .    .    |
|    .    .    .    .    .    .    .    .    .    D  12.  12.* 12.* 12.  12.  12D    |    |    .    .    .    .    .    .    .    |
|----|-------------------|SSSS-----|---------|----| . . . . . . . . . . . . . . | . .|----|----------DDDD|-------------------|. . |
|    |    .    .    .    |    .    |    .    |    |    .    .    .    .    .    |    |    .    .    .    |    .    .    .    |    |
|    |  06.  06.  06.  06|  08.  08|  09.  09|    |  12.  12.  12.  12.  12.  12|    |  19.  19.  19.  19|  21.  21.  21.  21|    |
|----|. . . . . . . . . .|. . . . .|. . . . .|. . | . . . . . . . . . . . . . . | . .|. . . . . . . . . .|. . . . . . . . . .|. . |
|    |    .    .    .    |    .    D    .Mor |    |    .    .    .    .    .    |    S    .    .    .    |    .    .    .    |    |
|    |  06.  06.  06.  06|  08.  08D  09.  09|    |  12.  12.  12.  12.  12.  12|    S  19.  19.  19.  19|  21.  21.  21.  21|    |
| . .|. . . . . . . . . .|. . . . .|. . . . .|. . |------------------------|----| . .|. . . . . . . . . .|. . . . . . . . . .|. . |
|    D    .    .    .    |    .    |    .    |    .    .    .    .    .    |    .    |    .    .    .    |    .    .    .    |    |
|    D  06.  06.  06.  06|  08.  08|  09.  09|    .    .    .    .    .    |    .    |  19.  19.  19.  19|  21.  21.  21.  21|    |
| . .|. . . . . . . . . .|DDDD-----|---------|--------------| . . . . |----|---------|DDDD| . . . . . . .|. . . . . . . . . .|. . |
|    |    .    .    .    |    .    .    .    |    .    .    |    .    |    .    .    .    |    .    .    |    .    .    .    |    |
|    |  06.  06.  06.  06|  03.  03.  03.  03|  11.  11.  11|    .    |  18.  18.  18.  18|  19.  19.  19|  21.  21.  21.  21|    |
| . .|-------------------|. . . . . . . . . .|. . . . . . . | . . . . | . . . . . . . . . |--------------|-------------------|. . |
|    |    .    .    .    |    .    .    .    |    .    .    |    .    |    .Mor .    .    |    .    .    |    .    .    .    |    |
|    |  07.  07.  07.  07|  03.  03.  03.  03|  11.  11.  11|    .    |  18.  18.  18.  18|  20.  20.  20|  22.  22.  22.  22|    |
| . .|. . . . . . . . . .|. . . . . . . . . .|. . . . . . . | . . . . | . . . . . . . . . | . . . . . . .|. . . . . . . . . .|. . |
|    |    .    .    .    |    .    .    .    |    .    .    |    .    |    .    .    .    |    .    .    |    .    .    .    |    |
|    |  07.  07.  07.  07|  03.  03.  03.  03|  11.  11.  11|    .    |  18.  18.  18.  18|  20.  20.  20|  22.  22.  22.  22|    |
| . .|. . . . . . . . . .|. . . . . . . . . .|. . . . . . . | . . . . | . . . . . . . . . | . . . . . . .|. . . . . . . . . .|. . |
|    |    .    .    .    |    .    .    .    |    .    .    |    .    |    .    .    .    |    .    .    |    .    .    .    |    |
|    |  07.  07.  07.  07|  03.  03.  03.  03|  11.  11.  11|    .    |  18.  18.  18.  18|  20.  20.  20|  22.  22.  22.  22|    |
| . .|. . . . . . . . . .|. . . . . . . . . .|. . . . . . . | . . . . | . . . . . . . . . | . . . . . . .|. . . . . . . . . .|. . |
|    |    .    .    .    |    .    .    .    |    .    .    |    .    |    .    .    .    |    .    .    |    .    .    .    |    |
|    |  07.  07.  07.  07|  03.  03.  03.  03|  11.  11.  11|    .    |  18.  18.  18.  18|  20.  20.  20|  22.  22.  22.  22|    |
| . .|-------------------|-----DDDD----------|----|----|----|---------|-----DDDD----------|--------------|-------------------|. . |
|   X.    .    .    .    .    .    .    .    .    |    |    .    .    .    .    .    .    .    .    .    .    .    .    .    .   X|
|    .    .    .    .    .    .    .    .    .    |    |    .    .    .    .    .    .    .    .    .    .    .    .    .    .    |
|-------------------------------------------------|----|--------------------------------------------------------------------------|
